F 26,	25, 0
NO ./texture/12.xpm
	SO ./texture/5.xpm
WE ./texture/03.xpm
R 	1280 720


	 EA	 ./texture/4.xpm
S 	./texture/sprite.xpm
C  25,	26,	200

    11111111111111111111111111111
    1 1 1000000002110000000000001
    11111011000001110000000000001
        1001000000000000000000001
111111111011000001110000000010001
100000000011000001110111111111111
11110111111111011100000010001
11110111111111011101010010001
 1000000112121011100000010001
11000000000000000000000010201
1E000000000000001101010010001
10000000000000001101010010001
1100000111012121111121111000111
11112111 1112121 101111010001
11111111 1111111 111111111111



