############################################
##234#44##34##4324####1123#344234####32344##
#341234234123411123411234342341234123412343#
#26  1  2345      123423 347    123423   23#
#1        7   13    12            21     34#
#4    56       24       4    56       24 23#
#347  8    3    1234   347  8    3    1234##
#2       1243      23 22       1243      23#
#1     1234#2341             1234#2341  812#
#23  623#######123  21234  623#######12  83#
##42  74##1234###4  33##42  74##1234##32 51#
#321   1234 1234#12  4#321   1234 1234#1234#
#26   43      12##33 14#26  43      12######
#3   12   5    23##432##3   12   5   23#################################################
#4        6  b  34#####4        6     34#######234#44##34##4324####1123411411112341141##
#11    7     3   24####11    7     3   24####3412342341234432134##23431234123412341234##
##21   5  c  21   1#####21   5     21   1###326  1  2345      123423 347            712#
###23             2######23     8      62###21        7         12                   23#
####21    431     3#######21   6431     123474    75       24       4    68     24   34#
####17   73#25   12#######17   73#25     3           7         65                   84##
##436     123   24#######36     123   7     8    5        24       4    57    13    34##
#43            12######43             612 5126                  86                   52#
#1  1      7   3#######1  1      7   343123343      8        7         12            62#
#2      a     12#######2            12##234##11    347  8   53    1234   347  8    334##
#321         12########321         12#########21            1243         21       12423#
###21  n   123###########21      123############17  1    1234#234123412        1234#232#
###1111234114############1111234114#############1234234114############1234234114########
########################################################################################
