############################################
#341234234123411123411234312341234123412341#
#26  1  2345      123423 347              2#
#1        7   13    12                    2#
#4    56       24       4    56       24 34#
#347  8    3    1234   347  8    3    1234##
#2       1243      23 22       1243      23#
#1     1234#2341             1234#2341    2#
#23  623#######123  21234  623#######123  2#
##42  74##1234###4  33##42  74##1234###2 51#
#321   1234 1234#12  4#321   1234 1234#1234#
#26   43      12##33 14#26  43      12######
#3   12   5    23##432##3   12   5   23#####
#4        6     34#####4        6     34####
#11    7     3   24####11    7     3   24###
##21   5     21   1#####21   5     21   1###
###23             2######23             2###
####21    431     3#######21    431     3###
####17   73#25   12#######17   73#25   12###
##436     123   24#######36     123   24####
#43            12######43            12#####
#1  1      7   3#######1  1      7   3######
#2            12#######2            12######
#321   n     12########321         12#######
###21      123###########21      123########
###1111234114############1111234114#########
############################################
